7 10 3 2
 *******  
 *     ***
**#***   *
* O #  # *
* @@* # **
**@@*   * 
 ******** 
