# # # # # # # # # # 
# *   # #   #     # 
# #         #   # # 
# #   # #   #   # # 
# #     #       # # 
# # #   # # # # # # 
#   #   #         # 
#   #   # #   #     
#             #   # 
# # # # # # # # # # 