17 47
###############################################
###############################################
####              $############################
#### ######## ##############           ########
#### ########           #### ######### ########
#### #######  ############## #       # ########
####    #### ############### # ##### # ########
####### ####             ### #    @# # ########
####### #### ######## ###### ####### # ########
#######       ####### ######         # ########
############# ####### ################ ########
#####################                  ########
##################### #########################
#############         #########################
###############################################
###############################################
###############################################
