18 45
#############################################
############   #####       ##################
############ ############# ##################
############ ##          # ##################
############ ## ########## #        #########
############ ## #*   ##### ######## #########
############ ## #### ##### #%     # #########
############ ## #### ##### ### #### #########
############ ## #    ##### ### #### #########
############ ## #### ##### ### #### #########
############### #### ##### ### #### #########
#################### ##### ### #### #########
######            *# ##### #     @# #########
###### ############# ##### ######## #########
###### #############%#####          #########
###### ######################################
######^######################################
   #     #                                   
