#####*#
#.###.#
#.##..#
#....##
#.##.##
#...###
###@###