0R0000000
0    0  0
0  0 0  0
0   00  E
0       0
0  *  0 0
0     0 0
0  0    0
000000000