1 1 1 1 1 1 1 1 1 1
1 1 1 1 1 1 1 1 1 1
1 1 1 1 1 4 1 1 1 1
1 1 1 1 1 0 1 1 1 1
1 1 4 3 0 3 1 1 1 1
1 1 1 1 2 3 0 4 1 1
1 1 1 1 3 1 1 1 1 1
1 1 1 1 4 1 1 1 1 1
1 1 1 1 1 1 1 1 1 1
1 1 1 1 1 1 1 1 1 1