1 1 1 1 1 1 1 1 1 1
1 1 1 1 1 1 1 1 1 1
1 1 0 0 0 0 0 1 1 1
1 1 3 1 1 1 0 0 0 1
1 0 2 0 3 0 0 3 0 1
1 0 4 4 1 0 3 0 1 1
1 1 4 4 1 0 0 0 1 1
1 1 1 1 1 1 1 1 1 1
1 1 1 1 1 1 1 1 1 1
1 1 1 1 1 1 1 1 1 1