1 1 1 1 1 1 1 0 0 0
1 0 0 4 2 0 1 1 1 0
1 0 4 2 4 2 0 0 1 0
1 5 2 4 2 4 3 0 1 0
1 0 4 2 4 2 0 1 1 0
1 0 0 4 2 0 0 1 0 0
1 1 1 1 1 1 1 1 0 0
0 0 0 0 0 0 0 0 0 0