      # # # #   
  # # #   * #   
  #     O   #   
# #   #   # # # 
#     #   # a # 
#   #     O a # 
#   O       a # 
# # # # # # # # 
