0,1,1,1,1,0
1,1,0,0,1,0
1,4,3,0,1,0
1,1,3,0,1,1
1,1,0,3,0,1
1,2,3,0,0,1
1,2,2,5,2,1
1,1,1,1,1,1