8 8
...###..
...#x#..
#### #..
#xB B###
###@B x#
..#B####
..#x#...
..###...
