******************************
*                *           *
*                *           *
*                *           *
*                *           *
*                *           *
*                *           *
********         *           *
*      *         *     *******
*      *         *           *
*      *         *           *
*      *         *           *
*      *         *           *
*                *           *
*                *           *
*                *           *
*                *           *
*                *           *
*                *           *
*                *           *
*                *     *     *
*                *     *     *
*                *     *     *
*                *     *     *
*                *     *     *
*                      *     *
**********             *     *
*                      *     *
*                      *     *
******************************
