5 5 5 5 5 5 
5 1 5 0 0 5
5 0 5 0 2 5
5 0 0 3 0 5
5 0 5 0 0 5
5 5 5 5 5 5