##########
##########
###X######
###*######
###  *X###
#X* @#####
####*#####
####X#####
##########
##########