******************************
*                            *
*                            *
*                            *
*       **********************
*                            *
*                            *
*************************    *
*                            *
*                            *
*                            *
*                            *
*************************    *
*                            *
*                            *
*       **********************
*                            *
*                            *
*                            *
*       **********************
*                            *
*                            *
*                            *
*       **********************
*                            *
*                            *
*                            *
*                            *
*                            *
******************************
