9 9
#####....
#@  #....
# BB#.###
# B #.#x#
### ###x#
.##    x#
.#   #  #
.#   ####
.#####...
