5 5 5 5 5 0 0 0 0 0 0 0 0 0 0 0 0 0 0 0
5 1 0 0 5 0 0 0 0 0 0 0 0 0 0 0 0 0 0 0
5 0 3 3 5 0 5 5 5 0 0 0 0 0 0 0 0 0 0 0
5 0 3 0 5 0 5 2 5 0 0 0 0 0 0 0 0 0 0 0
5 5 5 0 5 5 5 2 5 0 0 0 0 0 0 0 0 0 0 0
0 5 5 0 0 0 0 2 5 0 0 0 0 0 0 0 0 0 0 0
0 5 0 0 0 5 0 0 5 0 0 0 0 0 0 0 0 0 0 0
0 5 0 0 0 5 5 5 5 0 0 0 0 0 0 0 0 0 0 0
0 5 5 5 5 5 0 0 0 0 0 0 0 0 0 0 0 0 0 0
0 0 0 0 0 0 0 0 0 0 0 0 0 0 0 0 0 0 0 0  
0 0 0 0 0 0 0 0 0 0 0 0 0 0 0 0 0 0 0 0  
0 0 0 0 0 0 0 0 0 0 0 0 0 0 0 0 0 0 0 0  
0 0 0 0 0 0 0 0 0 0 0 0 0 0 0 0 0 0 0 0  
0 0 0 0 0 0 0 0 0 0 0 0 0 0 0 0 0 0 0 0  
0 0 0 0 0 0 0 0 0 0 0 0 0 0 0 0 0 0 0 0  
0 0 0 0 0 0 0 0 0 0 0 0 0 0 0 0 0 0 0 0  
0 0 0 0 0 0 0 0 0 0 0 0 0 0 0 0 0 0 0 0  
0 0 0 0 0 0 0 0 0 0 0 0 0 0 0 0 0 0 0 0  
0 0 0 0 0 0 0 0 0 0 0 0 0 0 0 0 0 0 0 0 
0 0 0 0 0 0 0 0 0 0 0 0 0 0 0 0 0 0 0 0   
