##########
#@  ######
# **######
# * ###X##
### ###X##
###    X##
##   #  ##
##   #####
##########
##########
