##########
##     ###
##*###   #
# @ *  * #
# XX# * ##
##XX#   ##
##########
##########
##########
##########