7 10
.#######..
.#     ###
##B###   #
# @ B  B #
# xx# B ##
##xx#   #.
.########.
