8 6
.####.
##  #.
#@B #.
##B ##
## B #
#xB  #
#xxBx#
######
