8 8
.#####..
.#@ ###.
.# B  #.
### # ##
#x# #  #
#xB  # #
#x   B #
########
