0 5 5 5 5 5 0 0 0 0 0 0 0 0 0 0 0 0 0 0 
0 5 1 0 5 5 5 0 0 0 0 0 0 0 0 0 0 0 0 0
0 5 0 3 0 0 5 0 0 0 0 0 0 0 0 0 0 0 0 0
5 5 5 0 5 0 5 5 0 0 0 0 0 0 0 0 0 0 0 0
5 2 5 0 5 0 0 5 0 0 0 0 0 0 0 0 0 0 0 0
5 2 3 0 0 5 0 5 0 0 0 0 0 0 0 0 0 0 0 0
5 2 0 0 0 3 0 5 0 0 0 0 0 0 0 0 0 0 0 0
5 5 5 5 5 5 5 5 0 0 0 0 0 0 0 0 0 0 0 0
0 0 0 0 0 0 0 0 0 0 0 0 0 0 0 0 0 0 0 0
0 0 0 0 0 0 0 0 0 0 0 0 0 0 0 0 0 0 0 0
0 0 0 0 0 0 0 0 0 0 0 0 0 0 0 0 0 0 0 0
0 0 0 0 0 0 0 0 0 0 0 0 0 0 0 0 0 0 0 0
0 0 0 0 0 0 0 0 0 0 0 0 0 0 0 0 0 0 0 0
0 0 0 0 0 0 0 0 0 0 0 0 0 0 0 0 0 0 0 0
0 0 0 0 0 0 0 0 0 0 0 0 0 0 0 0 0 0 0 0
0 0 0 0 0 0 0 0 0 0 0 0 0 0 0 0 0 0 0 0
0 0 0 0 0 0 0 0 0 0 0 0 0 0 0 0 0 0 0 0
0 0 0 0 0 0 0 0 0 0 0 0 0 0 0 0 0 0 0 0
0 0 0 0 0 0 0 0 0 0 0 0 0 0 0 0 0 0 0 0
0 0 0 0 0 0 0 0 0 0 0 0 0 0 0 0 0 0 0 0