8 10
...#######
..##  # @#
..#   #  #
..#B B B #
..# B##  #
### # # ##
#xxxxx  #.
#########.
