7 10
...######.
.###    #.
##x B## ##
#xxB B  @#
#xx B B ##
######  #.
.....####.
