0 0 0 5 5 5 5 5 5 0 0 0 0 0 0 0 0 0 0 0
0 5 5 5 0 0 0 0 5 0 0 0 0 0 0 0 0 0 0 0 
5 5 2 0 3 5 5 0 5 5 0 0 0 0 0 0 0 0 0 0
5 2 2 3 0 3 0 0 1 5 0 0 0 0 0 0 0 0 0 0 
5 2 2 0 3 0 3 0 5 5 0 0 0 0 0 0 0 0 0 0
5 5 5 5 5 5 0 0 5 0 0 0 0 0 0 0 0 0 0 0
0 0 0 0 0 5 5 5 5 0 0 0 0 0 0 0 0 0 0 0
0 0 0 0 0 0 0 0 0 0 0 0 0 0 0 0 0 0 0 0
0 0 0 0 0 0 0 0 0 0 0 0 0 0 0 0 0 0 0 0
0 0 0 0 0 0 0 0 0 0 0 0 0 0 0 0 0 0 0 0
0 0 0 0 0 0 0 0 0 0 0 0 0 0 0 0 0 0 0 0
0 0 0 0 0 0 0 0 0 0 0 0 0 0 0 0 0 0 0 0
0 0 0 0 0 0 0 0 0 0 0 0 0 0 0 0 0 0 0 0
0 0 0 0 0 0 0 0 0 0 0 0 0 0 0 0 0 0 0 0
0 0 0 0 0 0 0 0 0 0 0 0 0 0 0 0 0 0 0 0
0 0 0 0 0 0 0 0 0 0 0 0 0 0 0 0 0 0 0 0
0 0 0 0 0 0 0 0 0 0 0 0 0 0 0 0 0 0 0 0
0 0 0 0 0 0 0 0 0 0 0 0 0 0 0 0 0 0 0 0
0 0 0 0 0 0 0 0 0 0 0 0 0 0 0 0 0 0 0 0
0 0 0 0 0 0 0 0 0 0 0 0 0 0 0 0 0 0 0 0