9 11
.#########.
.#  ##   #.
.#   B   #.
.#B ### B#.
.# #xxx# #.
## #xxx# ##
# B  B  B #
#     # @ #
###########
