 _            _        _ 
| |_ __ _ ___| | __   / |
| __/ _` / __| |/ /   | |
| || (_| \__ \   <    | |
 \__\__,_|___/_|\_\___|_|
                 |_____| 
