 _            _        ____  
| |_ __ _ ___| | __   |___ \ 
| __/ _` / __| |/ /     __) |
| || (_| \__ \   <     / __/ 
 \__\__,_|___/_|\_\___|_____|
                 |_____|     
