 _            _        _____ 
| |_ __ _ ___| | __   |___ / 
| __/ _` / __| |/ /     |_ \ 
| || (_| \__ \   <     ___) |
 \__\__,_|___/_|\_\___|____/ 
                 |_____|     
