 _            _     _  _   
| |_ __ _ ___| | __| || |  
| __/ _` / __| |/ /| || |_ 
| || (_| \__ \   < |__   _|
 \__\__,_|___/_|\_\___|_|  
                 |_____|   
