 _            _        ____  
| |_ __ _ ___| | __   | ___| 
| __/ _` / __| |/ /   |___ \ 
| || (_| \__ \   <     ___) |
 \__\__,_|___/_|\_\___|____/ 
                 |_____|     
