 _            _       _____ 
| |_ __ _ ___| | __  |___  |
| __/ _` / __| |/ /     / / 
| || (_| \__ \   <     / /  
 \__\__,_|___/_|\_\___/_/   
                 |_____|    
