 _            _        ___  
| |_ __ _ ___| | __   ( _ ) 
| __/ _` / __| |/ /   / _ \ 
| || (_| \__ \   <   | (_) |
 \__\__,_|___/_|\_\___\___/ 
                 |_____|    
