####################
#    #x#           #
#    # #           #
#    #*#############
#    #   s    *   x#
######*#############
#    # #           #
#    #x#           #
####################
#########
# s #   #
# **# ###
# * # #x#
### ###x#
###    x#
##   #  #
##   ####
#########
########
#   #  #
# # #*x#
#    *x#
# # #*x#
#   #  #
#####s #
    ####