* * * * * * * * * *
* * * * * * * * * *
* * * *   x * * * *
* *     + +     * *
*           *   * *
*     *   * *   * *
* *   # o       * *
* *     * * * * * *
* * * * * * * * * *
* * * * * * * * * *
2 10
3
3 8
3 10
6 8
