* * * * * * * * * *
* * * * * * * * * *
* * * * *       * *
* * *           * *
* *   + + +   * * *
* *     + x   * * *
* *   o + # * * * *
* * *       * * * *
* * * *     * * * *
* * * * * * * * * *
5 10
6
4 6
6 6
4 8
4 10
5 8
6 8
