**********
*     @  *
*  #     *
*        *
*@       *
*     #  *
*        *
*  #     *
*     @  *
********** 6 1 1 4 6 8  4 5