**********
****@   **
******# **
****     *
*@**     *
* **  #  *
*     ****
* **  ****
*   #   @*
********** 4 1 1 4 8 8 5 5