**********
****    **
******  **
****     *
*@**  # **
*@**  # **
*@    ****
* **# ****
*        *
********** 1 5 1 4 1 6 5 5