****************************************************
*	            ÇëÑ¡Ôñ¿Î³Ì		           *
*					           *
*	1.Math	                		   *
*	2.C++/C        				   *
*	3.English				   *
*						   *
*						   *
*						   *
*						   *
*						   *
*						   *
*						   *
****************************************************