********************
*                  *
*                  *
*     ********     *
*     ********     *
*     ********     *
*     ********     *
*                  *
*                  *
* ******************